ac-adapter|ac-adapter|normal
accessories-calculator|accessories-calculator|normal
accessories-character-map|accessories-character-map|normal
accessories-dictionary|accessories-dictionary|normal
accessories-text-editor|accessories-text-editor|normal
address-book-new|address-book-new|normal
applets-screenshooter|applets-screenshooter|normal
application-certificate|application-certificate|normal
application-exit|application-exit|normal
applications-accessories|applications-accessories|normal
applications-development|applications-development|normal
applications-engineering|applications-engineering|normal
applications-games|applications-games|normal
applications-graphics|applications-graphics|normal
applications-internet|applications-internet|normal
applications-multimedia|applications-multimedia|normal
applications-office|applications-office|normal
applications-other|applications-other|normal
applications-science|applications-science|normal
applications-system|applications-system|normal
applications-utilities|applications-utilities|normal
application-x-executable|application-x-executable|normal
appointment-missed|appointment-missed|normal
appointment-new|appointment-new|normal
appointment-soon|appointment-soon|normal
audio-card|audio-card|normal
audio-input-microphone|audio-input-microphone|normal
audio-volume-high|audio-volume-high|normal
audio-volume-low|audio-volume-low|normal
audio-volume-medium|audio-volume-medium|normal
audio-volume-muted|audio-volume-muted|normal
audio-x-generic|audio-x-generic|normal
avatar-default|avatar-default|normal
battery|battery|normal
battery-caution|battery-caution|normal
battery-caution-charging|battery-caution-charging|normal
battery-empty|battery-empty|normal
battery-full|battery-full|normal
battery-full-charged|battery-full-charged|normal
battery-full-charging|battery-full-charging|normal
battery-good|battery-good|normal
battery-good-charging|battery-good-charging|normal
battery-low|battery-low|normal
battery-low-charging|battery-low-charging|normal
battery-missing|battery-missing|normal
bookmark-new|bookmark-new|normal
call-start|call-start|normal
call-stop|call-stop|normal
camera-photo|camera-photo|normal
camera-video|camera-video|normal
camera-web|camera-web|normal
changes-allow|changes-allow|normal
changes-prevent|changes-prevent|normal
computer|computer|normal
computer-fail|computer-fail|normal
contact-new|contact-new|normal
debian-swirl|debian-swirl|normal
dialog-error|dialog-error|normal
dialog-information|dialog-information|normal
dialog-password|dialog-password|normal
dialog-question|dialog-question|normal
dialog-warning|dialog-warning|normal
document-new|document-new|normal
document-open|document-open|normal
document-open-recent|document-open-recent|normal
document-page-setup|document-page-setup|normal
document-print|document-print|normal
document-print-preview|document-print-preview|normal
document-properties|document-properties|normal
document-revert|document-revert|normal
document-save-as|document-save-as|normal
document-save|document-save|normal
document-send|document-send|normal
drive-harddisk|drive-harddisk|normal
drive-optical|drive-optical|normal
drive-removable-media|drive-removable-media|normal
edit-clear|edit-clear|normal
edit-copy|edit-copy|normal
edit-cut|edit-cut|normal
edit-delete|edit-delete|normal
edit-find|edit-find|normal
edit-find-replace|edit-find-replace|normal
edit-paste|edit-paste|normal
edit-redo|edit-redo|normal
edit-select-all|edit-select-all|normal
edit-undo|edit-undo|normal
emblem-default|emblem-default|normal
emblem-desktop|emblem-desktop|normal
emblem-documents|emblem-documents|normal
emblem-downloads|emblem-downloads|normal
emblem-favorite|emblem-favorite|normal
emblem-generic|emblem-generic|normal
emblem-important|emblem-important|normal
emblem-mail|emblem-mail|normal
emblem-new|emblem-new|normal
emblem-package|emblem-package|normal
emblem-photos|emblem-photos|normal
emblem-readonly|emblem-readonly|normal
emblem-shared|emblem-shared|normal
emblem-symbolic-link|emblem-symbolic-link|normal
emblem-synchronizing|emblem-synchronizing|normal
emblem-system|emblem-system|normal
emblem-unreadable|emblem-unreadable|normal
emblem-urgent|emblem-urgent|normal
emblem-web|emblem-web|normal
face-angel|face-angel|normal
face-angry|face-angry|normal
face-cool|face-cool|normal
face-crying|face-crying|normal
face-devilish|face-devilish|normal
face-embarrassed|face-embarrassed|normal
face-glasses|face-glasses|normal
face-kiss|face-kiss|normal
face-laugh|face-laugh|normal
face-monkey|face-monkey|normal
face-plain|face-plain|normal
face-raspberry|face-raspberry|normal
face-sad|face-sad|normal
face-sick|face-sick|normal
face-smile-big|face-smile-big|normal
face-smile|face-smile|normal
face-smirk|face-smirk|normal
face-surprise|face-surprise|normal
face-tired|face-tired|normal
face-uncertain|face-uncertain|normal
face-wink|face-wink|normal
face-worried|face-worried|normal
folder-documents|folder-documents|normal
folder-download|folder-download|normal
folder-drag-accept|folder-drag-accept|normal
folder|folder|normal
folder-music|folder-music|normal
folder-new|folder-new|normal
folder-open|folder-open|normal
folder-pictures|folder-pictures|normal
folder-publicshare|folder-publicshare|normal
folder-remote|folder-remote|normal
folder-saved-search|folder-saved-search|normal
folder-templates|folder-templates|normal
folder-videos|folder-videos|normal
folder-visiting|folder-visiting|normal
font-x-generic|font-x-generic|normal
format-indent-less|format-indent-less|normal
format-indent-more|format-indent-more|normal
format-justify-center|format-justify-center|normal
format-justify-fill|format-justify-fill|normal
format-justify-left|format-justify-left|normal
format-justify-right|format-justify-right|normal
format-text-bold|format-text-bold|normal
format-text-direction-ltr|format-text-direction-ltr|normal
format-text-direction-rtl|format-text-direction-rtl|normal
format-text-italic|format-text-italic|normal
format-text-strikethrough|format-text-strikethrough|normal
format-text-underline|format-text-underline|normal
gnome-foot|gnome-foot|normal
go-bottom|go-bottom|normal
go-down|go-down|normal
go-first|go-first|normal
go-home|go-home|normal
go-jump|go-jump|normal
go-last|go-last|normal
go-next|go-next|normal
go-previous|go-previous|normal
go-top|go-top|normal
go-up|go-up|normal
help-about|help-about|normal
help-browser|help-browser|normal
help-contents|help-contents|normal
help-faq|help-faq|normal
image-loading|image-loading|normal
image-missing|image-missing|normal
image-x-generic|image-x-generic|normal
input-dialpad|input-dialpad|normal
input-gaming|input-gaming|normal
input-keyboard|input-keyboard|normal
input-mouse|input-mouse|normal
input-tablet|input-tablet|normal
input-touchpad|input-touchpad|normal
insert-image|insert-image|normal
insert-link|insert-link|normal
insert-object|insert-object|normal
insert-text|insert-text|normal
list-add|list-add|normal
list-remove|list-remove|normal
mail-attachment|mail-attachment|normal
mail-forward|mail-forward|normal
mail-mark-important|mail-mark-important|normal
mail-mark-junk|mail-mark-junk|normal
mail-mark-notjunk|mail-mark-notjunk|normal
mail-mark-read|mail-mark-read|normal
mail-mark-unread|mail-mark-unread|normal
mail-message-new|mail-message-new|normal
mail-read|mail-read|normal
mail-replied|mail-replied|normal
mail-reply-all|mail-reply-all|normal
mail-reply-sender|mail-reply-sender|normal
mail-send|mail-send|normal
mail-send-receive|mail-send-receive|normal
mail-signed|mail-signed|normal
mail-signed-verified|mail-signed-verified|normal
mail-unread|mail-unread|normal
media-eject|media-eject|normal
media-flash|media-flash|normal
media-floppy|media-floppy|normal
media-optical|media-optical|normal
media-playback-pause|media-playback-pause|normal
media-playback-start|media-playback-start|normal
media-playback-stop|media-playback-stop|normal
media-playlist-repeat|media-playlist-repeat|normal
media-playlist-shuffle|media-playlist-shuffle|normal
media-record|media-record|normal
media-removable|media-removable|normal
media-seek-backward|media-seek-backward|normal
media-seek-forward|media-seek-forward|normal
media-skip-backward|media-skip-backward|normal
media-skip-forward|media-skip-forward|normal
media-tape|media-tape|normal
microphone-sensitivity-high|microphone-sensitivity-high|normal
microphone-sensitivity-low|microphone-sensitivity-low|normal
microphone-sensitivity-medium|microphone-sensitivity-medium|normal
microphone-sensitivity-muted|microphone-sensitivity-muted|normal
modem|modem|normal
multimedia-player|multimedia-player|normal
multimedia-volume-control|multimedia-volume-control|normal
network-error|network-error|normal
network-idle|network-idle|normal
network-offline|network-offline|normal
network-receive|network-receive|normal
network-server|network-server|normal
network-transmit|network-transmit|normal
network-transmit-receive|network-transmit-receive|normal
network-vpn|network-vpn|normal
network-wired-disconnected|network-wired-disconnected|normal
network-wired|network-wired|normal
network-wireless-encrypted|network-wireless-encrypted|normal
network-wireless|network-wireless|normal
network-workgroup|network-workgroup|normal
non-starred|non-starred|normal
object-flip-horizontal|object-flip-horizontal|normal
object-flip-vertical|object-flip-vertical|normal
object-rotate-left|object-rotate-left|normal
object-rotate-right|object-rotate-right|normal
package-x-generic|package-x-generic|normal
pda|pda|normal
phone|phone|normal
preferences-desktop-accessibility|preferences-desktop-accessibility|normal
preferences-desktop-display|preferences-desktop-display|normal
preferences-desktop-font|preferences-desktop-font|normal
preferences-desktop-keyboard|preferences-desktop-keyboard|normal
preferences-desktop-keyboard-shortcuts|preferences-desktop-keyboard-shortcuts|normal
preferences-desktop-locale|preferences-desktop-locale|normal
preferences-desktop-peripherals|preferences-desktop-peripherals|normal
preferences-desktop-personal|preferences-desktop-personal|normal
preferences-desktop|preferences-desktop|normal
preferences-desktop-remote-desktop|preferences-desktop-remote-desktop|normal
preferences-desktop-screensaver|preferences-desktop-screensaver|normal
preferences-desktop-theme|preferences-desktop-theme|normal
preferences-desktop-wallpaper|preferences-desktop-wallpaper|normal
preferences-other|preferences-other|normal
preferences-system-network|preferences-system-network|normal
preferences-system|preferences-system|normal
preferences-system-windows|preferences-system-windows|normal
printer-error|printer-error|normal
printer-network|printer-network|normal
printer|printer|normal
printer-printing|printer-printing|normal
process-stop|process-stop|normal
process-working|process-working|normal
scanner|scanner|normal
security-high|security-high|normal
security-low|security-low|normal
security-medium|security-medium|normal
software-update-available|software-update-available|normal
software-update-urgent|software-update-urgent|normal
speaker|speaker|normal
starred|starred|normal
swirl-foot|swirl-foot|normal
system-file-manager|system-file-manager|normal
system-help|system-help|normal
system-lock-screen|system-lock-screen|normal
system-log-out|system-log-out|normal
system-run|system-run|normal
system-search|system-search|normal
system-shutdown|system-shutdown|normal
system-software-install|system-software-install|normal
system-software-update|system-software-update|normal
system-users|system-users|normal
tab-new|tab-new|normal
task-due|task-due|normal
task-past-due|task-past-due|normal
text-html|text-html|normal
text-x-generic-template|text-x-generic-template|normal
text-x-generic|text-x-generic|normal
text-x-preview|text-x-preview|normal
text-x-script|text-x-script|normal
tools-check-spelling|tools-check-spelling|normal
ubuntu-logo|ubuntu-logo|normal
user-available|user-available|normal
user-away|user-away|normal
user-bookmarks|user-bookmarks|normal
user-busy|user-busy|normal
user-desktop|user-desktop|normal
user-home|user-home|normal
user-idle|user-idle|normal
user-info|user-info|normal
user-invisible|user-invisible|normal
user-offline|user-offline|normal
user-trash-full|user-trash-full|normal
user-trash|user-trash|normal
utilities-system-monitor|utilities-system-monitor|normal
utilities-terminal|utilities-terminal|normal
video-display|video-display|normal
video-x-generic|video-x-generic|normal
view-fullscreen|view-fullscreen|normal
view-refresh|view-refresh|normal
view-restore|view-restore|normal
view-sort-ascending|view-sort-ascending|normal
view-sort-descending|view-sort-descending|normal
weather-clear-night-000|weather-clear-night-000|normal
weather-clear-night-010|weather-clear-night-010|normal
weather-clear-night-020|weather-clear-night-020|normal
weather-clear-night-030|weather-clear-night-030|normal
weather-clear-night-040|weather-clear-night-040|normal
weather-clear-night-050|weather-clear-night-050|normal
weather-clear-night-060|weather-clear-night-060|normal
weather-clear-night-070|weather-clear-night-070|normal
weather-clear-night-080|weather-clear-night-080|normal
weather-clear-night-090|weather-clear-night-090|normal
weather-clear-night-100|weather-clear-night-100|normal
weather-clear-night-110|weather-clear-night-110|normal
weather-clear-night-120|weather-clear-night-120|normal
weather-clear-night-130|weather-clear-night-130|normal
weather-clear-night-140|weather-clear-night-140|normal
weather-clear-night-150|weather-clear-night-150|normal
weather-clear-night-160|weather-clear-night-160|normal
weather-clear-night-170|weather-clear-night-170|normal
weather-clear-night-190|weather-clear-night-190|normal
weather-clear-night-200|weather-clear-night-200|normal
weather-clear-night-210|weather-clear-night-210|normal
weather-clear-night-220|weather-clear-night-220|normal
weather-clear-night-230|weather-clear-night-230|normal
weather-clear-night-240|weather-clear-night-240|normal
weather-clear-night-250|weather-clear-night-250|normal
weather-clear-night-260|weather-clear-night-260|normal
weather-clear-night-270|weather-clear-night-270|normal
weather-clear-night-280|weather-clear-night-280|normal
weather-clear-night-290|weather-clear-night-290|normal
weather-clear-night-300|weather-clear-night-300|normal
weather-clear-night-310|weather-clear-night-310|normal
weather-clear-night-320|weather-clear-night-320|normal
weather-clear-night-330|weather-clear-night-330|normal
weather-clear-night-340|weather-clear-night-340|normal
weather-clear-night-350|weather-clear-night-350|normal
weather-clear-night|weather-clear-night|normal
weather-clear|weather-clear|normal
weather-few-clouds-night-000|weather-few-clouds-night-000|normal
weather-few-clouds-night-010|weather-few-clouds-night-010|normal
weather-few-clouds-night-020|weather-few-clouds-night-020|normal
weather-few-clouds-night-030|weather-few-clouds-night-030|normal
weather-few-clouds-night-040|weather-few-clouds-night-040|normal
weather-few-clouds-night-050|weather-few-clouds-night-050|normal
weather-few-clouds-night-060|weather-few-clouds-night-060|normal
weather-few-clouds-night-070|weather-few-clouds-night-070|normal
weather-few-clouds-night-080|weather-few-clouds-night-080|normal
weather-few-clouds-night-090|weather-few-clouds-night-090|normal
weather-few-clouds-night-100|weather-few-clouds-night-100|normal
weather-few-clouds-night-110|weather-few-clouds-night-110|normal
weather-few-clouds-night-120|weather-few-clouds-night-120|normal
weather-few-clouds-night-130|weather-few-clouds-night-130|normal
weather-few-clouds-night-140|weather-few-clouds-night-140|normal
weather-few-clouds-night-150|weather-few-clouds-night-150|normal
weather-few-clouds-night-160|weather-few-clouds-night-160|normal
weather-few-clouds-night-170|weather-few-clouds-night-170|normal
weather-few-clouds-night-190|weather-few-clouds-night-190|normal
weather-few-clouds-night-200|weather-few-clouds-night-200|normal
weather-few-clouds-night-210|weather-few-clouds-night-210|normal
weather-few-clouds-night-220|weather-few-clouds-night-220|normal
weather-few-clouds-night-230|weather-few-clouds-night-230|normal
weather-few-clouds-night-240|weather-few-clouds-night-240|normal
weather-few-clouds-night-250|weather-few-clouds-night-250|normal
weather-few-clouds-night-260|weather-few-clouds-night-260|normal
weather-few-clouds-night-270|weather-few-clouds-night-270|normal
weather-few-clouds-night-280|weather-few-clouds-night-280|normal
weather-few-clouds-night-290|weather-few-clouds-night-290|normal
weather-few-clouds-night-300|weather-few-clouds-night-300|normal
weather-few-clouds-night-310|weather-few-clouds-night-310|normal
weather-few-clouds-night-320|weather-few-clouds-night-320|normal
weather-few-clouds-night-330|weather-few-clouds-night-330|normal
weather-few-clouds-night-340|weather-few-clouds-night-340|normal
weather-few-clouds-night-350|weather-few-clouds-night-350|normal
weather-few-clouds-night|weather-few-clouds-night|normal
weather-few-clouds|weather-few-clouds|normal
weather-fog|weather-fog|normal
weather-overcast|weather-overcast|normal
weather-severe-alert|weather-severe-alert|normal
weather-showers-scattered|weather-showers-scattered|normal
weather-showers|weather-showers|normal
weather-snow|weather-snow|normal
weather-storm|weather-storm|normal
web-browser|web-browser|normal
window-close|window-close|normal
window-new|window-new|normal
x-office-address-book|x-office-address-book|normal
x-office-calendar|x-office-calendar|normal
x-office-document-template|x-office-document-template|normal
x-office-document|x-office-document|normal
x-office-drawing-template|x-office-drawing-template|normal
x-office-drawing|x-office-drawing|normal
x-office-presentation-template|x-office-presentation-template|normal
x-office-presentation|x-office-presentation|normal
x-office-spreadsheet-template|x-office-spreadsheet-template|normal
x-office-spreadsheet|x-office-spreadsheet|normal
zoom-fit-best|zoom-fit-best|normal
zoom-in|zoom-in|normal
zoom-original|zoom-original|normal
zoom-out|zoom-out|normal
